Water
3
H 0 0 0 0 0 0 1 0
H 0 0 1 0 0 0 0 0
O 0 0 1 0 0 0 1 0
###########
#..#......#
#.1#......#
#.##......#
#.#..#.####
#....#.3..#
###.#.....#
#2....#...#
###########