Ethylene
6
H 0 0 0 1 0 0 0 0
H 0 1 0 0 0 0 0 0
C 0 0 2 0 0 1 0 1
C 0 1 0 1 0 0 2 0
H 0 0 0 0 0 1 0 0
H 0 0 0 0 0 0 0 1
###.....###
#.#.....#.#
#2#######.#
#......#..#
##..4.#...#
#.#....5#3#
#...#....##
#..#....61#
#.#######.#
#.#.....#.#
###.....###
