Formic Acid
5
H 0 0 1 0 0 0 0 0
O 0 0 0 0 2 0 0 0
C 2 0 1 0 0 0 1 0
O 0 0 1 0 0 0 1 0
H 0 0 0 0 0 0 1 0
#############
#...........#
###..###..###
#.....#.....#
#.###...###.#
#.#2..#...#.#
#1435###....#
#.#...#...#.#
#.###...###.#
#.....#.....#
###..###..###
#...........#
#############
