Methane
5
H 0 0 1 0 0 0 0 0
H 0 0 0 0 1 0 0 0
C 1 0 1 0 1 0 1 0
H 1 0 0 0 0 0 0 0
H 0 0 0 0 0 0 1 0
#############
#...#..#....#
#.#..#5#....#
#..#...#3.#.#
#......####.#
#.......#1#.#
#.2..#..#...#
#.#####....##
#.4.#..#...#.
#####..#...#.
.......#####.